AllScripts=Todos los scripts
ClassName=Nombre de la clase
CodeRunning=El código está ejecutándose...
DebugCancel=Cancelar
DebugContinue=Continuar
DebugStepOver=Saltar a la siguiente
DebugStop=Parar de depurar
Dependencies=Dependencias
DependenciesCaption=Dependencias de %1
DownloadAsXml=Descargar
Editor=Editor
EditScript=Editar script
Execute=Ejecutar
ExecutionCompleted=La ejecución ha finalizado.
ExecutionCompletedError=La ejecución ha finalizado con errores.
ExecutionCompleteWait=El proceso sigue en ejecución.
ExecutionParameters=Parámetros de ejecución
ExecutionPaused=La ejecución está detenida...
ExportAsJson=Exportar como MXT
ExportRunnableClass=Exportar ejecutable
GlobalTtsAbort=Emitir ttsAbort global
GlobalTtsAbortHelpText=Envuelve la ejecución en una transacción global que finaliza en un ttsAbort.
InvalidPropertyError=Propiedad inválida %1
Language=Lenguaje
Links=Enlaces
LoadFromFile=Cargar desde archivo
MaxLoopIterations=Limitación de iteraciones
MXTWorkspace=MXT Intérprete de X++
NewLabel0=Label files created on 04/04/2024 16:18:17 for label file Id MXT and language en-US
 ;Label file comment - see above label
NewScript=Nuevo script
NewScriptCaption=Nuevo script*
NothingToExecute=No hay nada para ejecutar...
OpenForExecution=Abrir para la ejecución
OpenGithubRepository=Repositorio en Github
OpenInEditor=Abrir en el Editor
Operations=Operaciones
Schedule=Lote
Script=Script
ScriptId=Script ID
Scripts=Scripts
SourceCode=Código fuente
TSql=T-Sql
VariableInspectorName=Nombre
VariableInspectorType=Tipo
VariableInspectorValue=Valor
Xpp=X++
XppCodeInterpreter=Editor de X++
XppCodeRunner=Ejecutor de X++
XppInterpreterParameters=Parámetros del intérprete
XppInterpreterParametersSimple=Configuración
